11111111111111111111
10010011110000000011
10111000000110101011
100C0010110101010101
10101110110000000001
10100010111111111111
10101010000000000001
10111011111000010001
1C101011000111110001
1E0P0011000000000C01
11111111111111111111