1111111111
10P00C1111
1000E111111
1111111111