1111111
100C111
1000P11
1E11111
1111111


