111111111
1P0000011
1C00000E1
111111111
